WWWWWWWW
W00W00XW
W00W000W
W000000W
W0W000XW
WWWWWWWW
1,1
2,5
3,4